"Team","Date","Game_ID","Season","Opponent","Is_Home","TOI","GF%","SF%","FF%","CF%","xGF%","GF","GA","SF","SA","FF","FA","CF","CA","xGF","xGA","G±","S±","F±","C±","xG±"
"DET","2015-10-09","2015020014","20152016","TOR","1",50.05,100,51.28,49.09,52.17,50.75,3,0,20,19,27,28,36,33,1.58,1.53,3,1,-1,3,0.05
"DET","2015-10-10","2015020023","20152016","CAR","0",49.5,66.67,36.54,31.65,35.35,40.51,4,2,19,33,25,54,35,64,1.8,2.65,2,-14,-29,-29,-0.85
"DET","2015-10-13","2015020042","20152016","T.B","1",47.92,50,51.43,53.45,55.84,62.29,1,1,18,17,31,27,43,34,1.5,0.91,0,1,4,9,0.59
"DET","2015-10-16","2015020060","20152016","CAR","1",49.28,42.86,37.5,37.88,41.03,33.15,3,4,18,30,25,41,32,46,1.47,2.96,-1,-12,-16,-14,-1.49
"DET","2015-10-17","2015020065","20152016","MTL","0",45.72,50,36.96,40,40.24,31.82,1,1,17,29,24,36,33,49,1.19,2.54,0,-12,-12,-16,-1.36
"DET","2015-10-21","2015020090","20152016","EDM","0",43.23,33.33,45,51.79,54.17,38.47,1,2,18,22,29,27,39,33,1.66,2.66,-1,-4,2,6,-1
"DET","2015-10-23","2015020103","20152016","CGY","0",53.05,0,40.35,40,46.67,34.42,0,2,23,34,30,45,49,56,1.22,2.33,-2,-11,-15,-7,-1.11
"DET","2015-10-24","2015020116","20152016","VAN","0",47.35,100,47.73,39.68,42.11,41.34,2,0,21,23,25,38,32,44,1.26,1.79,2,-2,-13,-12,-0.53
"DET","2015-10-27","2015020127","20152016","CAR","1",50.65,33.33,57.14,57.41,52.94,57.36,1,2,24,18,31,23,36,32,1.68,1.25,-1,6,8,4,0.43
"DET","2015-10-30","2015020149","20152016","OTT","1",41.08,0,42.22,47.37,52.11,42.86,0,2,19,26,27,30,37,34,0.96,1.29,-2,-7,-3,3,-0.32
"DET","2015-10-31","2015020158","20152016","OTT","0",48.83,50,45.65,46.48,43.62,44.45,3,3,21,25,33,38,41,53,1.67,2.09,0,-4,-5,-12,-0.42
"DET","2015-11-03","2015020176","20152016","T.B","1",46.4,100,51.11,50.94,47.06,61,2,0,23,22,27,26,32,36,1.77,1.13,2,1,1,-4,0.64
"DET","2015-11-06","2015020194","20152016","TOR","0",47.6,100,42.11,38.71,41.46,43.01,2,0,16,22,24,38,34,48,1.66,2.2,2,-6,-14,-14,-0.54
"DET","2015-11-08","2015020211","20152016","DAL","1",46.25,0,42.86,50,54.55,47.73,0,1,15,20,26,26,36,30,1.34,1.46,-1,-5,0,6,-0.13
"DET","2015-11-10","2015020220","20152016","WSH","1",50.73,100,48,55.38,55.84,63.72,1,0,24,26,36,29,43,34,1.76,1,1,-2,7,9,0.76
"DET","2015-11-13","2015020244","20152016","S.J","1",52.5,25,64.86,63.46,68.18,46.1,1,3,24,13,33,19,45,21,1.63,1.9,-2,11,14,24,-0.28
"DET","2015-11-14","2015020247","20152016","BOS","0",51.83,0,38.78,48.57,52.81,43.52,0,3,19,30,34,36,47,42,1.56,2.02,-3,-11,-2,5,-0.46
"DET","2015-11-16","2015020264","20152016","OTT","0",54.15,60,57.69,55.26,51.92,57.9,3,2,30,22,42,34,54,50,2.63,1.91,1,8,8,4,0.72
"DET","2015-11-18","2015020276","20152016","WSH","1",45.18,50,55.26,51.79,52.17,48,1,1,21,17,29,27,36,33,1.3,1.4,0,4,2,3,-0.11
"DET","2015-11-20","2015020289","20152016","L.A","1",48.82,66.67,44.64,43.24,43.18,47.02,2,1,25,31,32,42,38,50,2.27,2.55,1,-6,-10,-12,-0.29
"DET","2015-11-21","2015020300","20152016","STL","0",56.98,50,44.44,44,46.15,51.22,3,3,24,30,33,42,48,56,2.46,2.35,0,-6,-9,-8,0.12
"DET","2015-11-25","2015020325","20152016","BOS","1",54.17,40,64.58,65.52,65.79,72.7,2,3,31,17,38,20,50,26,2.77,1.04,-1,14,18,24,1.73
"DET","2015-11-27","2015020338","20152016","EDM","1",54.3,66.67,56,49.32,50.53,57.45,4,2,28,22,36,37,48,47,3.02,2.24,2,6,-1,1,0.78
"DET","2015-11-29","2015020354","20152016","FLA","1",44.78,33.33,51.11,57.89,55.41,54.15,1,2,23,22,33,24,41,33,1.62,1.37,-1,1,9,8,0.25
"DET","2015-12-01","2015020362","20152016","BUF","1",58.07,60,63.24,63.64,60.64,69.68,3,2,43,25,49,28,57,37,3.51,1.53,1,18,21,20,1.98
"DET","2015-12-03","2015020377","20152016","ARI","1",49.63,83.33,58.46,60.81,61.11,72.47,5,1,38,27,45,29,55,35,3.01,1.14,4,11,16,20,1.87
"DET","2015-12-05","2015020391","20152016","NSH","1",49.52,75,51.06,54.84,59.04,64.45,3,1,24,23,34,28,49,34,1.98,1.09,2,1,6,15,0.89
"DET","2015-12-08","2015020409","20152016","WSH","0",55.98,66.67,42.86,45.45,50.53,43.91,2,1,21,28,30,36,48,47,1.1,1.4,1,-7,-6,1,-0.3
"DET","2015-12-10","2015020421","20152016","MTL","1",45.65,50,52.38,56.36,57.53,41.53,2,2,22,20,31,24,42,31,1.28,1.8,0,2,7,11,-0.52
"DET","2015-12-11","2015020428","20152016","N.J","0",51.77,0,41.07,43.08,41.33,42.69,0,2,23,33,28,37,31,44,2.28,3.06,-2,-10,-9,-13,-0.78
"DET","2015-12-14","2015020452","20152016","BUF","1",47.92,33.33,47.17,44.12,47.5,44.9,1,2,25,28,30,38,38,42,2.09,2.56,-1,-3,-8,-4,-0.47
"DET","2015-12-18","2015020481","20152016","VAN","1",54.42,40,35.85,39.34,42.5,43.87,2,3,19,34,24,37,34,46,2.06,2.64,-1,-15,-13,-12,-0.58
"DET","2015-12-20","2015020496","20152016","CGY","1",46.72,100,59.26,60,58.97,70.49,3,0,32,22,39,26,46,32,2.76,1.15,3,10,13,14,1.6
"DET","2015-12-22","2015020509","20152016","N.J","1",46.25,25,58.06,58.7,63.64,45.76,1,3,18,13,27,19,35,20,1.66,1.97,-2,5,8,15,-0.31
"DET","2015-12-26","2015020522","20152016","NSH","0",49.77,50,50,46.55,45.78,57.89,2,2,20,20,27,31,38,45,2.12,1.54,0,0,-4,-7,0.58
"DET","2015-12-28","2015020538","20152016","MIN","0",51.17,0,38.89,40.62,51.72,25.28,0,1,21,33,26,38,45,42,0.98,2.91,-1,-12,-12,3,-1.92
"DET","2015-12-29","2015020547","20152016","WPG","0",46.8,0,55.81,54.84,59.76,58.74,0,2,24,19,34,28,49,33,2.15,1.51,-2,5,6,16,0.64
"DET","2015-12-31","2015020557","20152016","PIT","1",48.33,50,47.37,46.88,50.62,32.64,2,2,27,30,30,34,41,40,1.56,3.22,0,-3,-4,1,-1.66
"DET","2016-01-02","2015020567","20152016","BUF","0",45.02,75,42.86,47.37,55.13,41.54,3,1,18,24,27,30,43,35,1.37,1.93,2,-6,-3,8,-0.56
"DET","2016-01-04","2015020583","20152016","N.J","0",52.7,100,50,44.44,43.04,53.03,1,0,21,21,24,30,34,45,1.69,1.49,1,0,-6,-11,0.19
"DET","2016-01-07","2015020607","20152016","S.J","0",49.47,66.67,41.07,36.36,42.27,35.53,2,1,23,33,28,49,41,56,1.23,2.23,1,-10,-21,-15,-1
"DET","2016-01-10","2015020628","20152016","ANA","0",48.05,66.67,46.81,46.15,48.51,45.58,2,1,22,25,36,42,49,52,1.9,2.27,1,-3,-6,-3,-0.37
"DET","2016-01-11","2015020633","20152016","L.A","0",53.5,66.67,42.86,43.42,45,33.03,2,1,21,28,33,43,45,55,1.27,2.58,1,-7,-10,-10,-1.31
"DET","2016-01-14","2015020652","20152016","ARI","0",52.88,50,40.91,51.35,51.11,52.02,1,1,18,26,38,36,46,44,1.88,1.74,0,-8,2,2,0.15
"DET","2016-01-17","2015020675","20152016","PHI","1",49.45,50,56.41,62.71,62.82,63.25,1,1,22,17,37,22,49,29,1.81,1.05,0,5,15,20,0.76
"DET","2016-01-20","2015020690","20152016","STL","1",48.95,0,57.14,59.26,61.43,56.09,0,2,24,18,32,22,43,27,1.67,1.31,-2,6,10,16,0.36
"DET","2016-01-22","2015020703","20152016","BUF","0",48.7,100,69.09,62.35,59.22,69.72,2,0,38,17,53,32,61,42,3.18,1.38,2,21,21,19,1.8
"DET","2016-01-23","2015020713","20152016","ANA","1",42.62,40,45.45,42.31,42.42,40.25,2,3,20,24,22,30,28,38,1.27,1.88,-1,-4,-8,-10,-0.61
"DET","2016-01-25","2015020725","20152016","NYI","0",55.17,50,45.83,49.28,45.74,46.16,2,2,22,26,34,35,43,51,2,2.33,0,-4,-1,-8,-0.33
"DET","2016-02-03","2015020757","20152016","T.B","0",49.47,50,54.76,51.67,55.7,41.67,1,1,23,19,31,29,44,35,1.11,1.55,0,4,2,9,-0.44
"DET","2016-02-04","2015020764","20152016","FLA","0",40.75,25,45.24,44.23,50,48.14,1,3,19,23,23,29,34,34,1.23,1.32,-2,-4,-6,0,-0.09
"DET","2016-02-06","2015020778","20152016","NYI","1",47.43,100,36.84,40,41.56,50.36,4,0,14,24,24,36,32,45,1.25,1.23,4,-10,-12,-13,0.02
"DET","2016-02-08","2015020793","20152016","FLA","1",43.75,100,59.52,53.73,54.17,69.45,2,0,25,17,36,31,39,33,3.21,1.41,2,8,5,6,1.8
"DET","2016-02-10","2015020806","20152016","OTT","1",41.73,100,57.14,53.57,56.92,60.03,1,0,24,18,30,26,37,28,2.04,1.36,1,6,4,9,0.68
"DET","2016-02-12","2015020821","20152016","COL","1",51.75,33.33,68.52,67.57,72.73,65.48,1,2,37,17,50,24,72,27,3.63,1.91,-1,20,26,45,1.71
"DET","2016-02-14","2015020837","20152016","BOS","1",49.32,50,55.56,61.67,61.97,59.69,4,4,25,20,37,23,44,27,1.7,1.15,0,5,14,17,0.55
"DET","2016-02-15","2015020840","20152016","NYI","0",45.25,25,51.06,52.38,54.35,54.22,1,3,24,23,33,30,50,42,2.86,2.42,-2,1,3,8,0.45
"DET","2016-02-18","2015020859","20152016","PIT","0",54.97,37.5,48.61,52.75,52.25,55.22,3,5,35,37,48,43,58,53,2.96,2.4,-2,-2,5,5,0.56
"DET","2016-02-20","2015020876","20152016","OTT","0",56.9,50,57.45,59.32,55.26,75.17,2,2,27,20,35,24,42,34,2.71,0.9,0,7,11,8,1.81
"DET","2016-02-21","2015020885","20152016","NYR","0",45.92,0,48.84,45.31,46.34,38.76,0,1,21,22,29,35,38,44,1.49,2.35,-1,-1,-6,-6,-0.86
"DET","2016-02-23","2015020896","20152016","CBJ","1",56.65,0,50,54.29,56.63,50.19,0,1,26,26,38,32,47,36,1.93,1.91,-1,0,6,11,0.01
"DET","2016-02-27","2015020927","20152016","COL","0",43.23,57.14,45.65,46.97,50.55,57.5,4,3,21,25,31,35,46,45,1.89,1.39,1,-4,-4,1,0.49
"DET","2016-02-29","2015020941","20152016","DAL","0",50.28,66.67,44.83,45.68,47.57,39.62,2,1,26,32,37,44,49,54,2.01,3.06,1,-6,-7,-5,-1.05
"DET","2016-03-02","2015020952","20152016","CHI","1",51.5,25,50,52.17,51.69,62.61,1,3,27,27,36,33,46,43,2.88,1.72,-2,0,3,3,1.16
"DET","2016-03-06","2015020983","20152016","CHI","0",46.87,33.33,55.32,55.56,55.91,47.34,1,2,26,21,35,28,52,41,1.56,1.74,-1,5,7,11,-0.18
"DET","2016-03-08","2015020996","20152016","CBJ","0",40.83,33.33,47.73,52.54,51.28,41.54,1,2,21,23,31,28,40,38,1.8,2.53,-1,-2,3,2,-0.73
"DET","2016-03-10","2015021009","20152016","WPG","1",46.25,60,57.14,59.02,62.65,55.51,3,2,28,21,36,25,52,31,1.63,1.31,1,7,11,21,0.32
"DET","2016-03-12","2015021019","20152016","NYR","1",51.82,66.67,65.52,63.41,65,61.79,2,1,38,20,52,30,65,35,4.23,2.62,1,18,22,30,1.61
"DET","2016-03-13","2015021032","20152016","TOR","1",48.63,0,60,53.25,56.18,53.04,0,1,33,22,41,36,50,39,2.66,2.36,-1,11,5,11,0.31
"DET","2016-03-15","2015021039","20152016","PHI","0",48.52,42.86,48.53,50.57,54.7,49.97,3,4,33,35,44,43,64,53,2.53,2.53,-1,-2,1,11,0
"DET","2016-03-17","2015021055","20152016","CBJ","0",49.13,100,47.5,46.15,47.5,46.81,3,0,19,21,24,28,38,42,1.77,2.01,3,-2,-4,-4,-0.24
"DET","2016-03-19","2015021072","20152016","FLA","0",50.2,40,53.66,50,47.3,47.33,2,3,22,19,31,31,35,39,1.66,1.85,-1,3,0,-4,-0.19
"DET","2016-03-22","2015021093","20152016","T.B","0",52.33,16.67,46.94,48.53,54.88,33.16,1,5,23,26,33,35,45,37,1.47,2.96,-4,-3,-2,8,-1.49
"DET","2016-03-24","2015021105","20152016","MTL","1",51.23,50,55.93,60.49,61.22,66.16,3,3,33,26,49,32,60,38,2.94,1.5,0,7,17,22,1.44
"DET","2016-03-26","2015021115","20152016","PIT","1",49.45,16.67,37.25,39.71,40.51,29.83,1,5,19,32,27,41,32,47,1.33,3.12,-4,-13,-14,-15,-1.79
"DET","2016-03-28","2015021134","20152016","BUF","1",45.18,50,65.62,63.27,59.09,63.05,1,1,21,11,31,18,39,27,1.56,0.91,0,10,13,12,0.65
"DET","2016-03-29","2015021143","20152016","MTL","0",46.62,0,53.85,51.35,58.76,49.32,0,3,28,24,38,36,57,40,1.99,2.05,-3,4,2,17,-0.05
"DET","2016-04-01","2015021162","20152016","MIN","1",54.05,50,55.56,57.35,56.1,64.71,2,2,25,20,39,29,46,36,2.48,1.35,0,5,10,10,1.13
"DET","2016-04-02","2015021170","20152016","TOR","0",48.07,66.67,41.67,44.74,40.78,42.23,2,1,20,28,34,42,42,61,1.61,2.2,1,-8,-8,-19,-0.59
"DET","2016-04-06","2015021200","20152016","PHI","1",43.32,100,42.86,47.06,43.48,60.41,1,0,18,24,24,27,30,39,1.59,1.04,1,-6,-3,-9,0.55
"DET","2016-04-07","2015021202","20152016","BOS","0",45.23,33.33,29.73,31.37,38.36,15.75,2,4,11,26,16,35,28,45,0.5,2.69,-2,-15,-19,-17,-2.19
"DET","2016-04-09","2015021217","20152016","NYR","0",53.15,0,60,56.72,57.83,55.86,0,2,27,18,38,29,48,35,2.05,1.62,-2,9,9,13,0.43
"DET","Total","-","20152016","-","-",49.13,48.78,49.94,50.48,51.95,50.49,140,147,1946,1951,2689,2638,3556,3289,157.86,154.81,-7,-5,51,267,3.05
