"Team","Date","Game_ID","Season","Opponent","Is_Home","TOI","GF%","SF%","FF%","CF%","xGF%","GF","GA","SF","SA","FF","FA","CF","CA","xGF","xGA","G±","S±","F±","C±","xG±"
"NSH","2016-10-14","2016020014","20162017","CHI","1",46.62,0,55.26,51.72,44.16,46.67,0,2,21,17,30,28,34,43,1.36,1.55,-2,4,2,-9,-0.19
"NSH","2016-10-15","2016020026","20162017","CHI","0",52.25,40,63.27,57.35,56.67,59.58,2,3,31,18,39,29,51,39,2.4,1.63,-1,13,10,12,0.77
"NSH","2016-10-18","2016020043","20162017","DAL","1",49.48,0,43.14,37.68,42.16,42.03,0,2,22,29,26,43,43,59,1.34,1.85,-2,-7,-17,-16,-0.51
"NSH","2016-10-21","2016020064","20162017","DET","0",47.37,0,41.94,38.16,40.91,44.5,0,3,26,36,29,47,36,52,1.99,2.48,-3,-10,-18,-16,-0.49
"NSH","2016-10-22","2016020073","20162017","PIT","1",48.78,80,48.08,41.1,41.58,53.29,4,1,25,27,30,43,42,59,2.1,1.84,3,-2,-13,-17,0.26
"NSH","2016-10-26","2016020097","20162017","ANA","0",46.57,0,60,56.45,58.02,54.13,0,1,21,14,35,27,47,34,1.41,1.2,-1,7,8,13,0.22
"NSH","2016-10-27","2016020105","20162017","L.A","0",52.72,50,38.89,44.87,43.52,44.34,1,1,21,33,35,43,47,61,1.74,2.18,0,-12,-8,-14,-0.44
"NSH","2016-10-29","2016020122","20162017","S.J","0",54.73,33.33,50,52.56,57.02,54.73,1,2,23,23,41,37,65,49,2.79,2.31,-1,0,4,16,0.48
"NSH","2016-11-01","2016020140","20162017","COL","0",42.6,80,58.7,55.17,55.17,56.21,4,1,27,19,32,26,48,39,1.83,1.43,3,8,6,9,0.41
"NSH","2016-11-03","2016020155","20162017","ARI","0",45.68,33.33,48.94,50,53.49,58.11,1,2,23,24,32,32,46,40,1.45,1.04,-1,-1,0,6,0.4
"NSH","2016-11-05","2016020170","20162017","CAR","1",55,66.67,54.55,50,46.81,59,2,1,24,20,34,34,44,50,2.29,1.59,1,4,0,-6,0.7
"NSH","2016-11-08","2016020190","20162017","OTT","1",51.13,66.67,46.55,52.05,54.84,60.81,2,1,27,31,38,35,51,42,2.83,1.82,1,-4,3,9,1.01
"NSH","2016-11-10","2016020203","20162017","STL","1",46.9,75,45.45,50,46.74,55.09,3,1,20,24,36,36,43,49,1.81,1.48,2,-4,0,-6,0.33
"NSH","2016-11-12","2016020220","20162017","ANA","1",42.43,100,55.26,56.36,49.28,57.16,3,0,21,17,31,24,34,35,1.77,1.33,3,4,7,-1,0.44
"NSH","2016-11-15","2016020233","20162017","TOR","0",57.62,25,50,53,53.72,48.18,2,6,32,32,53,47,65,56,2.82,3.04,-4,0,6,9,-0.21
"NSH","2016-11-17","2016020248","20162017","OTT","0",44.83,100,58.06,57.5,55.34,65.1,5,0,36,26,46,34,57,46,2.83,1.51,5,10,12,11,1.31
"NSH","2016-11-19","2016020267","20162017","STL","0",46.07,0,42.55,43.55,44.05,34.5,0,3,20,27,27,35,37,47,1.21,2.29,-3,-7,-8,-10,-1.08
"NSH","2016-11-21","2016020279","20162017","T.B","1",50.95,100,52.17,49.21,48,58.76,2,0,24,22,31,32,36,39,2.37,1.66,2,2,-1,-3,0.71
"NSH","2016-11-23","2016020295","20162017","DAL","1",47.33,75,32.61,43.1,50,47.17,3,1,15,31,25,33,42,42,1.76,1.97,2,-16,-8,0,-0.21
"NSH","2016-11-25","2016020307","20162017","WPG","1",48.45,66.67,54.76,58.18,61.73,59.56,2,1,23,19,32,23,50,31,1.3,0.88,1,4,9,19,0.42
"NSH","2016-11-27","2016020325","20162017","WPG","0",42.37,0,60.47,56.9,59.49,44.32,0,1,26,17,33,25,47,32,1.64,2.06,-1,9,8,15,-0.42
"NSH","2016-11-29","2016020337","20162017","COL","0",52.08,62.5,52.54,55.26,54.13,62.04,5,3,31,28,42,34,59,50,1.75,1.07,2,3,8,9,0.68
"NSH","2016-12-03","2016020362","20162017","N.J","1",56.33,50,69.49,68.75,68.57,63.34,4,4,41,18,55,25,72,33,3.38,1.95,0,23,30,39,1.42
"NSH","2016-12-04","2016020373","20162017","PHI","1",46.25,66.67,63.64,59.38,60,68.23,2,1,28,16,38,26,51,34,1.73,0.8,1,12,12,17,0.92
"NSH","2016-12-06","2016020387","20162017","COL","1",46.15,75,59.09,56.25,57.78,62.11,3,1,26,18,36,28,52,38,1.95,1.19,2,8,8,14,0.76
"NSH","2016-12-08","2016020402","20162017","DAL","0",45.67,20,51.61,50,52.78,49.37,1,4,32,30,41,41,57,51,2.14,2.2,-3,2,0,6,-0.06
"NSH","2016-12-10","2016020418","20162017","ARI","0",47.9,20,55.56,57.65,61.17,50.22,1,4,35,28,49,36,63,40,1.72,1.71,-3,7,13,23,0.01
"NSH","2016-12-13","2016020437","20162017","STL","1",54.03,71.43,56.36,56.96,59.62,53.3,5,2,31,24,45,34,62,42,1.91,1.67,3,7,11,20,0.24
"NSH","2016-12-15","2016020450","20162017","MIN","1",52.33,33.33,62.79,61.43,61.11,48.91,1,2,27,16,43,27,55,35,1.72,1.8,-1,11,16,20,-0.08
"NSH","2016-12-17","2016020468","20162017","NYR","1",55,50,53.7,53.09,53.7,58.14,1,1,29,25,43,38,58,50,2.68,1.93,0,4,5,8,0.75
"NSH","2016-12-19","2016020476","20162017","PHI","0",56.3,50,51.92,50,53.85,48.28,1,1,27,25,36,36,56,48,1.36,1.45,0,2,0,8,-0.1
"NSH","2016-12-20","2016020482","20162017","N.J","0",53.78,75,54.55,51.52,51.9,54.71,3,1,30,25,34,32,41,38,1.79,1.48,2,5,2,3,0.31
"NSH","2016-12-22","2016020502","20162017","L.A","1",50,0,50,45.71,45.65,50.13,0,4,21,21,32,38,42,50,1.9,1.89,-4,0,-6,-8,0.01
"NSH","2016-12-27","2016020522","20162017","MIN","1",52.93,50,49.15,46.84,48.54,49.52,2,2,29,30,37,42,50,53,1.98,2.01,0,-1,-5,-3,-0.04
"NSH","2016-12-29","2016020537","20162017","CHI","1",43.7,50,65.79,60.71,62.5,58.82,1,1,25,13,34,22,50,30,0.85,0.6,0,12,12,20,0.26
"NSH","2016-12-30","2016020545","20162017","STL","0",43.23,100,54.05,51.67,46.25,64.21,2,0,20,17,31,29,37,43,1.71,0.95,2,3,2,-6,0.76
"NSH","2017-01-03","2016020570","20162017","MTL","1",54.5,33.33,36.21,38.46,37.38,45.87,1,2,21,37,30,48,40,67,1.92,2.27,-1,-16,-18,-27,-0.35
"NSH","2017-01-05","2016020580","20162017","T.B","0",45.87,100,40,35.71,31.25,44.08,4,0,14,21,20,36,25,55,1.17,1.49,4,-7,-16,-30,-0.32
"NSH","2017-01-06","2016020585","20162017","FLA","0",40.75,33.33,45.65,43.33,44.29,48.05,1,2,21,25,26,34,31,39,1.16,1.26,-1,-4,-8,-8,-0.09
"NSH","2017-01-08","2016020607","20162017","CHI","0",52.87,40,47.17,51.39,51.38,48.35,2,3,25,28,37,35,56,53,1.77,1.89,-1,-3,2,3,-0.12
"NSH","2017-01-10","2016020616","20162017","VAN","1",55.78,100,47.92,50.72,48.28,42.71,1,0,23,25,35,34,42,45,1.52,2.05,1,-2,1,-3,-0.52
"NSH","2017-01-12","2016020627","20162017","BOS","1",47.6,100,36.17,35.94,35.23,39.97,2,0,17,30,23,41,31,57,1.06,1.59,2,-13,-18,-26,-0.53
"NSH","2017-01-14","2016020641","20162017","COL","0",46.32,60,54.72,49.23,45,54.64,3,2,29,24,32,33,36,44,1.32,1.1,1,5,-1,-8,0.22
"NSH","2017-01-17","2016020670","20162017","VAN","0",54.92,0,50.98,50,48.35,57.08,0,1,26,25,33,33,44,47,1.88,1.41,-1,1,0,-3,0.47
"NSH","2017-01-19","2016020682","20162017","CGY","0",44.32,75,41.46,46.67,46.99,52.52,3,1,17,24,28,32,39,44,1.92,1.74,2,-7,-4,-5,0.18
"NSH","2017-01-20","2016020689","20162017","EDM","0",49.7,66.67,61.67,60.76,60.75,52.42,2,1,37,23,48,31,65,42,2.73,2.47,1,14,17,23,0.25
"NSH","2017-01-22","2016020707","20162017","MIN","0",52.47,60,58,56.34,56.25,46.13,3,2,29,21,40,31,54,42,1.65,1.93,1,8,9,12,-0.28
"NSH","2017-01-24","2016020720","20162017","BUF","1",54.17,33.33,46.97,41.11,43.1,37.71,2,4,31,35,37,53,50,66,1.85,3.06,-2,-4,-16,-16,-1.21
"NSH","2017-01-26","2016020735","20162017","CBJ","1",48.17,50,47.27,50,51.61,52.93,3,3,26,29,36,36,48,45,2.3,2.04,0,-3,0,3,0.25
"NSH","2017-01-31","2016020743","20162017","PIT","0",50.3,25,49.21,53.85,53.64,62.09,1,3,31,32,42,36,59,51,2.56,1.57,-2,-1,6,8,1
"NSH","2017-02-02","2016020762","20162017","EDM","1",46.73,100,50,43.94,48.19,42.4,2,0,23,23,29,37,40,43,1.67,2.28,2,0,-8,-3,-0.6
"NSH","2017-02-04","2016020780","20162017","DET","1",42.97,0,68,63.08,62.2,57.44,0,1,34,16,41,24,51,31,1.64,1.21,-1,18,17,20,0.42
"NSH","2017-02-07","2016020798","20162017","VAN","1",48.65,66.67,48.98,46.03,44.71,43.41,2,1,24,25,29,34,38,47,1.28,1.67,1,-1,-5,-9,-0.39
"NSH","2017-02-09","2016020804","20162017","NYR","0",53.05,20,50.85,54.67,54.84,50.37,1,4,30,29,41,34,51,42,2.26,2.23,-3,1,7,9,0.03
"NSH","2017-02-11","2016020818","20162017","FLA","1",42.87,33.33,48.98,47.54,51.95,50.72,2,4,24,25,29,32,40,37,1.61,1.57,-2,-1,-3,3,0.05
"NSH","2017-02-12","2016020831","20162017","DAL","1",40.25,100,67.57,70.69,67.44,71.75,2,0,25,12,41,17,58,28,2.43,0.96,2,13,24,30,1.47
"NSH","2017-02-18","2016020865","20162017","MIN","0",49.7,40,55.56,57.33,57,44.18,2,3,30,24,43,32,57,43,1.75,2.21,-1,6,11,14,-0.46
"NSH","2017-02-19","2016020874","20162017","CBJ","0",56.65,57.14,48.48,46.15,45.83,55.02,4,3,32,34,42,49,55,65,2.86,2.34,1,-2,-7,-10,0.52
"NSH","2017-02-21","2016020888","20162017","CGY","1",51.12,40,47.17,43.94,46.74,50.24,4,6,25,28,29,37,43,49,1.74,1.73,-2,-3,-8,-6,0.02
"NSH","2017-02-23","2016020897","20162017","COL","1",54.4,60,54.35,54.55,47,43.92,3,2,25,21,36,30,47,53,1.6,2.04,1,4,6,-6,-0.44
"NSH","2017-02-25","2016020906","20162017","WSH","1",51.53,50,47.73,48.44,50,41.58,2,2,21,23,31,33,42,42,1.18,1.66,0,-2,-2,0,-0.48
"NSH","2017-02-26","2016020915","20162017","EDM","1",48.02,50,50,49.09,45.07,42.28,2,2,23,23,27,28,32,39,1.41,1.93,0,0,-1,-7,-0.52
"NSH","2017-02-28","2016020923","20162017","BUF","0",51.63,50,55.17,54.76,54.37,53.9,4,4,32,26,46,38,56,47,2.38,2.03,0,6,8,9,0.34
"NSH","2017-03-02","2016020941","20162017","MTL","0",50.35,0,54.55,59.02,54.26,61.81,0,2,24,20,36,25,51,43,1.65,1.02,-2,4,11,8,0.63
"NSH","2017-03-04","2016020959","20162017","CHI","1",56.38,60,50.88,53.16,53.47,54.34,3,2,29,28,42,37,54,47,2,1.68,1,1,5,7,0.32
"NSH","2017-03-07","2016020981","20162017","ANA","0",55.93,33.33,35.09,35.16,32.79,43.69,1,2,20,37,32,59,40,82,2.58,3.32,-1,-17,-27,-42,-0.74
"NSH","2017-03-09","2016020993","20162017","L.A","0",54.55,100,45.65,47.3,47.92,66.86,2,0,21,25,35,39,46,50,3.3,1.64,2,-4,-4,-4,1.67
"NSH","2017-03-11","2016021001","20162017","S.J","0",47.9,66.67,48.84,41.94,45.05,37.95,2,1,21,22,26,36,41,50,1.19,1.95,1,-1,-10,-9,-0.76
"NSH","2017-03-13","2016021019","20162017","WPG","1",56.23,57.14,54.41,54.35,58.41,43.09,4,3,37,31,50,42,66,47,2.34,3.09,1,6,8,19,-0.75
"NSH","2017-03-16","2016021039","20162017","WSH","0",57.08,66.67,51.16,47.37,48.72,38.27,2,1,22,21,27,30,38,40,1.02,1.64,1,1,-3,-2,-0.62
"NSH","2017-03-18","2016021058","20162017","CAR","0",49.22,25,48.21,52.63,52.38,51.32,1,3,27,29,40,36,55,50,2.86,2.72,-2,-2,4,5,0.15
"NSH","2017-03-20","2016021072","20162017","ARI","1",54.27,100,56.36,56.1,58,62.84,3,0,31,24,46,36,58,42,2.61,1.55,3,7,10,16,1.07
"NSH","2017-03-23","2016021096","20162017","CGY","1",44.08,75,45.71,46,48.57,34.76,3,1,16,19,23,27,34,36,1.04,1.96,2,-3,-4,-2,-0.91
"NSH","2017-03-25","2016021114","20162017","S.J","1",50.12,80,55.1,59.09,56.7,69.84,4,1,27,22,39,27,55,42,3.14,1.35,3,5,12,13,1.78
"NSH","2017-03-27","2016021123","20162017","NYI","0",48.77,66.67,51.11,50.77,46.34,57.03,2,1,23,22,33,32,38,44,2.45,1.84,1,1,1,-6,0.6
"NSH","2017-03-28","2016021127","20162017","BOS","0",51.02,25,52.27,52.38,58.24,54.16,1,3,23,21,33,30,53,38,1.92,1.63,-2,2,3,15,0.3
"NSH","2017-03-30","2016021146","20162017","TOR","1",44.97,100,68.75,66.67,63.77,68.97,1,0,22,10,34,17,44,25,1.69,0.76,1,12,17,19,0.93
"NSH","2017-04-01","2016021158","20162017","MIN","1",52.58,100,50,50,53.06,59.36,2,0,29,29,37,37,52,46,2.43,1.66,2,0,0,6,0.77
"NSH","2017-04-02","2016021170","20162017","STL","0",46.68,0,52.17,48.33,51.16,39.72,0,4,24,22,29,31,44,42,1.29,1.96,-4,2,-2,2,-0.67
"NSH","2017-04-04","2016021185","20162017","NYI","1",55.42,33.33,42.86,42.11,42.06,42.75,1,2,21,28,32,44,45,62,1.59,2.13,-1,-7,-12,-17,-0.54
"NSH","2017-04-06","2016021200","20162017","DAL","0",50.77,66.67,49.09,44.44,47.37,44.04,6,3,27,28,36,45,54,60,2.91,3.7,3,-1,-9,-6,-0.79
"NSH","2017-04-08","2016021215","20162017","WPG","0",45.45,0,44.07,43.24,50,39.56,0,1,26,33,32,42,47,47,1.72,2.63,-1,-7,-10,0,-0.91
"NSH","Total","-","20162017","-","-",49.79,52.38,51.29,50.81,51.18,51.67,165,150,2105,1999,2904,2811,3915,3735,157.99,147.8,15,106,93,180,10.19
